16 14
0 0
0 0	0 0	0 0	0 0	0 0	0 0	0 0	0 0
0 6	4 5	4 7	7 7 2 2 2 2 1 1 1 0
0 1	1 1	1 1	1 1	1 1	1 2	1 1	1 0
0 1	1 1	1 1	1 1	1 1	1 17 1 1 1 0
0 1 1 16 15	15 15 16 2 1 1 2 14	14 2 0
0 1	1 1	1 1	1 1	2 1	1 3	1 1	1 0
0 17 1 1 1	1 1	1 2	1 1	3 1	1 1	0
0 2	1 1	1 2	2 2	2 17 2 2 14	1 1	0
0 2 1 1 1 1 1 6 7 14 1 1 1 1 1 0
0 2 1 1 1 1 1 6 7 14 1 1 1 1 1 0
0 2 1 1 1 1 1 6 7 14 1 1 1 1 1 0
0 2 1 1 1 1 1 6 7 14 1 1 1 1 1 0
0 2 2 2 2 2 5 6 7 14 1 1 1 1 1 0
0 0	0 0	0 0	0 0	0 0	0 0	0 0	0 0